2 0 0 0 0 8 3 0 5
1 0 0 0 0 6 0 0 0
9 6 0 0 7 0 2 0 0
0 5 0 6 0 0 8 0 0
0 0 0 0 2 0 0 0 0
0 0 2 0 0 1 0 9 0
0 0 1 0 6 0 0 5 3
0 0 0 3 0 0 0 0 8
4 0 3 0 8 0 0 2 0
 10
2 4 7 1 9 8 3 6 5
1 3 5 2 4 6 7 8 9
9 6 8 5 7 3 2 4 1
7 5 4 6 3 9 8 1 2
6 1 9 8 2 4 5 3 7
3 8 2 7 5 1 6 9 4
8 2 1 4 6 7 9 5 3
5 9 6 3 1 2 4 7 8
4 7 3 9 8 5 1 2 6